领料分包	收省拼侧片	next
收省拼侧片	分侧缝粘前袖弯	next
分侧缝粘前袖弯	拉前袖笼沙牵带	next
拉前袖笼沙牵带	前片推门	next
前片推门	拉前袖笼牵带,肩缝抛醋酸脂	next
拉前袖笼牵带,肩缝抛醋酸脂	劈手巾袋	next
劈手巾袋	扣手巾袋	next
扣手巾袋	机开手巾袋	next
机开手巾袋	分烫手巾袋	next
分烫手巾袋	装手巾袋布	next
装手巾袋布	封手巾袋外口,暗撬手巾袋	next
封手巾袋外口,暗撬手巾袋	劈袋盖	next
劈袋盖	割袋盖	next
割袋盖	反烫大袋盖,修烫大袋盖	next
反烫大袋盖,修烫大袋盖	机开大袋	next
机开大袋	剪,反烫大袋嵌	next
剪,反烫大袋嵌	装大袋布,辑袋贴	next
装大袋布,辑袋贴	打大袋套节	next
打大袋套节	叠,切胸衬	next
叠,切胸衬	复扎胸衬	next
复扎胸衬	烫驳口牵带	next
烫驳口牵带	中间压烫	next
中间压烫	撬驳头牵带,拆驳口扎线	next
撬驳头牵带,拆驳口扎线	修剪胸衬	next
修剪胸衬	拼挂面与前片里子,拼侧片	next
拼挂面与前片里子,拼侧片	烫挂面,里侧片缝	next
烫挂面,里侧片缝	定里袋位	next
定里袋位	粘里,卡袋嵌线	next
粘里,卡袋嵌线	机开里袋卡袋	next
机开里袋卡袋	剪,烫里卡袋嵌	next
剪,烫里卡袋嵌	烫三角	next
烫三角	打三角眼	next
打三角眼	钉商标	next
钉商标	辑里袋贴,装里袋布	next
辑里袋贴,装里袋布	烫里袋布	next
烫里袋布	撬里袋布	next
撬里袋布	里袋打套节	next
里袋打套节	复挂面,钉肩棉	next
复挂面,钉肩棉	扎驳头	next
扎驳头	夹止口拆扎线	next
夹止口拆扎线	止口检查	next
止口检查	修剪止口内缝	next
修剪止口内缝	分止口内缝,止口翻出	next
分止口内缝,止口翻出	烫外止口,对长短	next
烫外止口,对长短	撩缝(止口缝)	next
撩缝(止口缝)	扎成品挂面	next
扎成品挂面	对号上吊挂(全自动吊挂)	next
对号上吊挂(全自动吊挂)	几切被缝	next
几切被缝	拉后袖龙牵带	next
拉后袖龙牵带	归烫后背	next
归烫后背	拉后领圈牵带	next
拉后领圈牵带	辑里被缝	next
辑里被缝	拷面子摆缝	next
拷面子摆缝	烫面摆缝,背逢	next
烫面摆缝,背逢	拷里摆缝	next
拷里摆缝	烫里背摆缝,烫面底边	next
烫里背摆缝,烫面底边	拷面肩缝	next
拷面肩缝	分烫肩缝	next
分烫肩缝	扎领圈	next
扎领圈	拷面肩缝	next
拷面肩缝	劈领脚	next

						
	
			
				
				
		
							
				
												

			
		
		
	
	

		

